config/demo.pb	D:/projects/boba/config/demo.pb
config/generator2.pb	D:/projects/boba/config/generator2.pb
config/particles1.pb	D:/projects/boba/config/particles1.pb
gfx/Abstract_BG_Texture2.jpg	D:/projects/boba/gfx/Abstract_BG_Texture2.jpg
shaders/blur_BlurTransposeD.cso	D:/projects/boba/shaders/blur_BlurTransposeD.cso
shaders/blur_BoxBlurXD.cso	D:/projects/boba/shaders/blur_BoxBlurXD.cso
shaders/blur_BoxBlurYD.cso	D:/projects/boba/shaders/blur_BoxBlurYD.cso
shaders/blur_CopyTransposeD.cso	D:/projects/boba/shaders/blur_CopyTransposeD.cso
shaders/copy_PsMainD.pso	D:/projects/boba/shaders/copy_PsMainD.pso
shaders/debug_draw_PsMainD.pso	D:/projects/boba/shaders/debug_draw_PsMainD.pso
shaders/debug_draw_VsMainD.vso	D:/projects/boba/shaders/debug_draw_VsMainD.vso
shaders/fullscreen_PsMainD.pso	D:/projects/boba/shaders/fullscreen_PsMainD.pso
shaders/fullscreen_VsMainD.vso	D:/projects/boba/shaders/fullscreen_VsMainD.vso
shaders/generator_PsMainD.pso	D:/projects/boba/shaders/generator_PsMainD.pso
shaders/generator_VsMainD.vso	D:/projects/boba/shaders/generator_VsMainD.vso
shaders/quad_VsMainD.vso	D:/projects/boba/shaders/quad_VsMainD.vso
shaders/text_shader_EdgeDetectD.pso	D:/projects/boba/shaders/text_shader_EdgeDetectD.pso
shaders/text_shader_PsMainD.pso	D:/projects/boba/shaders/text_shader_PsMainD.pso
shaders/text_shader_VsMainD.vso	D:/projects/boba/shaders/text_shader_VsMainD.vso
shaders/tonemap_AdaptLuminanceD.pso	D:/projects/boba/shaders/tonemap_AdaptLuminanceD.pso
shaders/tonemap_BloomThresholdD.pso	D:/projects/boba/shaders/tonemap_BloomThresholdD.pso
shaders/tonemap_CompositeD.pso	D:/projects/boba/shaders/tonemap_CompositeD.pso
shaders/tonemap_LuminanceMapD.pso	D:/projects/boba/shaders/tonemap_LuminanceMapD.pso
